00000010
01110000
00010000
11000011
10000000
00111010
00000100
01000000