0000000000000000
0001000000011100
0110000000000100
0100000000000000
0100000011100000
0001000000110000
0001000000010000
0001000100010000
0001000100010000
0001000100110000
0001100100000000
0001000100000100
0000000000001100
0100000000011000
0010000000000000
0001000000000000
