0000000000000000
0000000000000000
0001111100000100
0000000000000100
0000000000000100
0000000000000100
0000000000000100
0000001111100000
0000000000000000
0000000000000000
0000000000000000
0010000001000011
0010000000000000
0011110000000000
0000000000000000
0000000000000000
