0010000010000000
0010000001000000
0001000000100000
0000100000100000
0000000000100011
0000000000100000
0000000000000000
0001000000000000
0000100000000000
0000000000000000
0000000001000011
0010000000100100
1100000000011000
0000011000000000
0000000000000000
0000000000000000
