0000000100000000
0000000100000000
0000000000000000
0010000000000000
0001000000000000
0000100111000000
0000000100000000
0000000100000000
0000000100000100
0000000100001000
0000000100010000
0000001100000000
0000001000000000
0010001000000000
0010001000000000
0010001000000000
